111111111111111
111111221111111
111111121111111
111111121111111
111222222111111
111111111111111
111111111111111
111111111111111
111111222111111
111111222111111
111111111111111
111111111111111
111111111112111
112221111112111
112111111112111
112111111111111
111111111111111
111111111111111
111111111111111
111111111222111
