001100000000000
001100000000000
001100000000000
000000011100000
000000001100000
000000000000000
111000000000000
111000110000000
000000100001110
000000110000010
000000100000000
100000000000000
111000000000000
001000011100000
000000000000000
000000000000000
000000000000000
000000000111000
000000000000000
000000000000000