111111111111111
121111111111111
111111111111111
111112222111111
111112111222111
111221111111111
111211111111111
111211111111111
111211111111111
111211111112111
111211111112111
111211111112111
111211111112111
111211111112111
111211111112111
111222222121111
111111111211111
111111111111111
111111111111121
111112111111111