111111111111111
111111111111111
111111111111111
111122222222111
111211111112111
111211111111111
111211111111111
111211111111111
111211111111111
111211111112111
111211111112111
111211111112111
111211111112111
111211111112111
111211111112111
111211111112111
111122222121111
111111111211111
111111111211111
111111111211111