111111111111111
111111111111111
111111111111111
111111111111111
111211111112111
111211111112111
111211111112111
111211111112111
111211111112111
111211111112111
111211111112111
111211111112111
111211111112111
111111111111111
111111111111111
111111111111111
111222222222111
111111111111111
111111111111111
111111111111111